6,1,5,homeaki (敏),[新聞] 韓四大集團發佈394億美元對美投資計劃,Sun May 23 09:42:26 2021
0,1,-1,Prof68 (veritas),Re,Sun May 23 09:34:38 2021
8,1,7,Avicenna (avicenna),[問卦] 有沒有三級警戒要不要延長的八卦,Sun May 23 06:53:49 2021
0,0,0,fickleness (小舞揭),[問卦] 誰該為這次疫情大爆發負責？抓到沒？,Sun May 23 10:05:51 2021
11,4,7,lilskies (K他命),[問卦]  誰他媽在卡BNT疫苗,Sun May 23 02:20:33 2021
9,2,7,sevenzgod (7z),[問卦] 認知作戰是在騙一般老百姓嗎,Sun May 23 01:39:17 2021
4,2,2,Dreamer48763 (小剛),[問卦] 旅館投宿的客人不見的八卦,Sun May 23 02:51:34 2021
8,3,5,Messi100 (立馬幫幫忙!),[問卦] 朋友在擔心打完疫苗會變無垢巨人 怎辦？,Sun May 23 07:17:19 2021
4,0,4,hayate232 (CY),[問卦] 國軍 四個月兵這樣訓練可以提升戰力嗎?,Sun May 23 07:12:01 2021
7,1,6,mdm (37.5度的愛情),Re,Sun May 23 09:39:02 2021
8,1,7,bezbol (o.o),Re,Sun May 23 01:38:55 2021
3,0,3,ilw4e (可以吃嗎？),Re,Sun May 23 07:41:51 2021
3,0,3,ForeverZARD (あの微笑みを忘れないで),[問卦] 請問yahoo有跟八卦版合作?,Sun May 23 09:42:05 2021
16,16,0,bjqs0827 (sqangela),[問卦] 假如現在是國民黨還是民眾黨執政,Sun May 23 09:22:27 2021
5,1,4,p5287058 (Franz991),[問卦] 一鍵收回側翼&覺青粉專的讚,Sun May 23 09:46:39 2021
6,14,-8,zsa123 (沉默的熊),[新聞] 【本土+1】管光中掌「新職籃聯盟」　台,Sun May 23 08:46:40 2021
5,3,2,a1005100 (dab),[問卦] 這時間是不是最適合打手槍的時間?,Sun May 23 03:35:20 2021
4,2,2,nightone1022 (夜哥),[問卦] 有沒有一直拿武漢死亡率說嘴的八卦,Sun May 23 06:21:29 2021
4,1,3,amou1030 ( 無名),Re,Sun May 23 09:18:06 2021
19,1,18,qscxz (奈米哥),[問卦] 這時間不睡覺的卦,Sun May 23 02:36:57 2021
7,1,6,ccyaztfe (best_troll_tw),[問卦] 燒烤是不是很奢侈的小吃啊？,Sun May 23 09:29:27 2021
3,0,3,popo1234 (我很好騙),[問卦] 「開放討論」是側翼之語嗎？,Sun May 23 08:31:13 2021
25,17,8,Superxixai (洪粉吱已),[新聞] 昔日學運神鵰俠侶！她曾與鄭文燦譜出戀,Sun May 23 08:24:49 2021
0,0,0,lolic (lolic),Re,Sun May 23 10:02:29 2021
0,3,-3,moanda (藍衣雨女),[問卦] 半夜武嶺亭群聚？,Sun May 23 02:14:27 2021
33,7,26,bbob (小海),[問卦] 歷史上最喜歡被高壓統治的一群人是誰?,Sun May 23 08:42:53 2021
27,11,16,mjj90138 (蔡包),[問卦] 剛剛怎麼了,Sun May 23 05:28:25 2021
3,7,-4,mean (低智商生活),Re,Sun May 23 03:24:41 2021
0,0,0,Gothel (gothel),[問卦] 有沒有林聖義人雄的八卦,Sun May 23 10:00:57 2021
6,0,6,xampp (xampp),Re,Sun May 23 09:15:16 2021
12,5,7,str8g (),[新聞] 1958年台海危機 美考慮核武攻擊中國捍衛,Sun May 23 09:10:43 2021
18,1,17,whiteadam (blue eyes blue),Re,Sun May 23 01:35:01 2021
0,0,0,elless (鬼島歌王廢慾清),Re,Sun May 23 08:14:17 2021
1,0,1,shrinkage (Shrinkage),[問卦] 做吃的利潤沒一半都是賠錢？,Sun May 23 09:46:25 2021
72,8,64,piggy37 (小時),[問卦] 言論自由跟造謠如何定義？,Sun May 23 09:37:23 2021
80,13,67,lovecyfen (lovecyfen),[問卦] 國產疫苗為何不直接上了啊??,Sun May 23 01:36:58 2021
10,5,5,god800411 (9527),[問卦] 台灣是不是要建個P4實驗室阿?,Sun May 23 03:24:54 2021
5,3,2,lcw33242976 (逆天改命，脫非入歐),[問卦] 好棒，三點了,Sun May 23 03:29:32 2021
3,0,3,whiteadam (blue eyes blue),[問卦] 這樣算是柔性封城?,Sun May 23 01:51:10 2021
5,0,5,oz5566 (威廉。霍恩索倫),[問卦] 同樣是國軍,Sun May 23 09:03:07 2021
2,5,-3,egro (人生就是需要不斷地修正),Re,Sun May 23 01:44:30 2021
6,10,-4,onetwogo (中國訊息報告工(正確版)),Re,Sun May 23 06:02:13 2021
0,1,-1,aBianSuck (阿扁),Re,Sun May 23 07:01:32 2021
13,9,4,neiltsang (楚留香雞排),[問卦] 覺得國片好看ㄉ腦子是出了什麼問題?,Sun May 23 02:16:03 2021
1,1,0,wayne4321 (),[問卦] 全力支持北中南廣設快篩站並公布數字,Sun May 23 09:49:39 2021
24,12,12,justin200428 (7788kkk),[問卦] 台灣人的末日是不是快了？,Sun May 23 04:34:12 2021
0,0,0,ME13 (小鳥),[問卦] 這樣午餐便當卡路里多少大概？,Sun May 23 10:04:41 2021
6,1,5,MoToBlue (MoToBlue),[問卦] 同島一命是這種概念嗎？,Sun May 23 06:56:33 2021
13,0,13,Ginpunch (南城阿鬼),[問卦] 有沒有物理治療所有沒有開門的八卦,Sun May 23 08:36:44 2021
19,0,19,bigbill (強顏歡笑完顏阿骨打),Re,Sun May 23 09:43:16 2021
6,5,1,RLAPH (川尻浩作),[問卦] 欸Netflix的海綿寶寶沒中文字幕試診樣,Sun May 23 06:11:19 2021
2,1,1,goodvictor (時空偵探),Re,Sun May 23 08:08:07 2021
7,1,6,kk10519 (星辰),[問卦] 請問今天還會校正回歸嗎？,Sun May 23 08:34:54 2021
8,1,7,tony84590 (喵咪起飛),Re,Sun May 23 06:39:57 2021
1,0,1,fredpig (奇奇),[問卦] 確診人數有必要校正回歸嗎？,Sun May 23 01:55:58 2021
0,0,0,Ryo5566 (),[問卦] 為什麼蟑螂幾乎都家徒四壁或赤貧?,Sun May 23 09:49:49 2021
6,6,0,ilovemami (聯絡簿教主),[問卦] 對面國為什麼都沒災情惹,Sun May 23 03:26:50 2021
8,3,5,lpbrother (LP哥(LP = Love & Peace)),[問卦] 為什麼只能等國產疫苗？,Sun May 23 07:18:54 2021
29,4,25,inse (好想退休),[新聞] 南投放水怪客 自帶鑰匙轉開水龍頭放水流,Sun May 23 07:38:10 2021
51,1,50,xianM (全職工具人),Re,Sun May 23 01:30:40 2021
9,3,6,erichang (哲),Re,Sun May 23 02:49:08 2021
0,0,0,Creeping (新天聾人),[問卦] 國稅局願意幫助防疫嗎,Sun May 23 10:03:15 2021
9,74,-65,posen2012 (posen),Re,Sun May 23 02:56:51 2021
1,3,-2,mikemagic88 (Mikemagic88),Re,Sun May 23 03:18:38 2021
5,1,4,ffdqfe (苦惱),[問卦] 所以現在機組人員是幾加幾？,Sun May 23 03:09:05 2021
4,0,4,CannyRowFour (知道還問),Re,Sun May 23 03:04:03 2021
3,4,-1,Whitening (whitening),Re,Sun May 23 09:21:42 2021
70,2,68,semih (Sayginer),[新聞] 莫德納委託三星生產新冠疫苗 文在寅出席,Sun May 23 08:25:03 2021
125,6,119,birdjack (啾啾啾),[問卦] 認真求問校正回歸,Sun May 23 02:38:12 2021
38,3,35,sakura000 (卍☆㊣煞氣★艋舺㊣☆卍),[新聞] 市府通知！萬華區青草園快篩站5月23日起,Sun May 23 09:20:29 2021
13,3,10,polostar (螺絲塔),Re,Sun May 23 03:31:02 2021
3,2,1,sushi11 (偶像可以亂摸嗎peko),[問卦] 玩SAO 的人是不是躲過這次的肺炎病毒,Sun May 23 09:41:42 2021
24,10,14,Skynet5566 (Skynet),[新聞]存貨面臨過期上海復星盼BNT疫苗輸台鴻海,Sun May 23 02:37:11 2021
24,4,20,postit (擁有秘密是快樂的事),[問卦] 以色列施打疫苗後的現況？,Sun May 23 03:59:57 2021
0,0,0,FcuKobe (逢甲狗鼻),[問卦] 行車糾紛下車打架要 戴口罩嗎,Sun May 23 10:03:46 2021
1,0,1,id44kimo (擁抱吧(B)),[問卦] 現在吵疫苗是不是沒用了,Sun May 23 07:13:31 2021
8,0,8,cns12852 (7D),[問卦] 下一個走上神壇的是不是行動支付,Sun May 23 09:33:28 2021
2,1,1,SRadiant (Radiant),Re,Sun May 23 08:39:54 2021
6,1,5,inse (好想退休),[問卦] 為什麼早餐店 都是高油 高碳水?,Sun May 23 07:56:07 2021
0,0,0,A1iesT (阿賴),[問卦] 乳清蛋白是不是健身仔的裝飾品?,Sun May 23 10:03:29 2021
23,2,21,ilanese (我寫故我在),[問卦] 謊言重覆一千遍，會變成真理嗎？,Sun May 23 02:03:05 2021
24,5,19,qazwsx1029 (含巨大長莖),[問卦] 如果打了疫苗還是確診台灣人會怎樣,Sun May 23 07:33:47 2021
0,0,0,qqq87112 (小Q),[問卦] 這波3+11的經濟虧損多大??,Sun May 23 10:05:38 2021
16,0,16,ZengMaktub (YOYOMAK),[問卦] 韓國怎麼從破產走到今天的？,Sun May 23 09:03:54 2021
8,1,7,a828203 (),[問卦] 好想去看看牆外的世界！,Sun May 23 09:46:29 2021
0,0,0,OPPAISuki (OPPAISuki),Re,Sun May 23 10:00:44 2021
7,0,7,utdsml (阿邊肥),[問卦] 今年比較慘還去年,Sun May 23 01:59:28 2021
16,1,15,zzahoward (Cheshire Cat),Re,Sun May 23 08:00:16 2021
4,0,4,qqq87112 (小Q),[問卦] 台灣484沒有輸??,Sun May 23 08:15:14 2021
1,0,1,todao (心裡有數),Re,Sun May 23 01:51:24 2021
9,0,9,yycbr (專注力+10),[問卦] 該放包子店倒嗎?,Sun May 23 06:07:57 2021
12,2,10,ILOVEluee (天天開心),[問卦] 各位鄉民要謹慎自己的發言了？,Sun May 23 08:19:25 2021
10,0,10,abram (科科),[問卦] 疫情期間人待在家 外面變成動物的世界？,Sun May 23 07:33:23 2021
0,0,0,wind200625 (killer wind),Re,Sun May 23 03:24:38 2021
0,0,0,taiwannext (2016綠營重新執政 ),[問卦]日本每天5000例武漢肺炎 地鐵還是擠？,Sun May 23 10:07:46 2021
169,3,166,rey123123 (小肥羊),[問卦]「校正回歸」的定義以及數據上不合理之處,Sun May 23 09:28:18 2021
9,1,8,tsuyoshi2501 (Tsuyoshi),[問卦] 其實不是超前部署，而是中了緩慢之術吧,Sun May 23 01:29:47 2021
11,2,9,ayun ( ′・ω・`),[問卦] 疫情在家聽搖滾樂。,Sun May 23 01:57:45 2021
5,5,0,abc12812 (),[問卦] 今年是台灣生技起飛的元年嗎?,Sun May 23 06:32:14 2021
61,14,47,thomas31035 (比爾),[新聞] 美韓峰會》拜登、文在寅敲定全方位疫苗合作計畫,Sun May 23 09:07:08 2021
59,9,50,arch20161219 (111),[爆卦] 供電吃緊 系統供電餘裕緊澀,Sun May 23 08:52:04 2021
6,0,6,chisland25 (kk),[問卦] 現在闖空門的小偷是不是要失業了？,Sun May 23 07:08:04 2021
6,2,4,XC312 (查莫斯東的徒弟),[問卦] 除濕機的原理是啥？,Sun May 23 03:27:19 2021
3,0,3,jason0120 (0.0),[問卦] 餐飲業的食材保存,Sun May 23 07:50:52 2021
5,0,5,voohong (SE Asia Fat Nerd),[問卦] 為什麼課本都要從101開始而不是001,Sun May 23 07:00:11 2021
1,5,-4,hi1576 (：),[問卦] PTT是什麼？？,Sun May 23 02:37:29 2021
3,1,2,BleedWang (),Re,Sun May 23 09:29:30 2021
6,5,1,Huffman (David),[問卦] 有國營基層員工確診沒人關心？,Sun May 23 03:47:16 2021
22,6,16,getter5566 (蓋特56),[新聞] 住家1樓開鎖店…關門吃飯遭開單「沒戴罩,Sun May 23 03:43:13 2021
5,2,3,mean (低智商生活),Re,Sun May 23 03:36:05 2021
4,1,3,LivingLouder (We're living louder),[問卦] 短期內集中精神的方法,Sun May 23 02:26:09 2021
9,2,7,aa83090202 (ylllewwww),[問卦] 大家多久沒吃芒果乾了,Sun May 23 09:10:05 2021
4,3,1,mjj90138 (蔡包),[問卦] 西門唐吉珂德會不會倒啊,Sun May 23 04:41:42 2021
3,2,1,WaWa3 (寂寞的麻糬),[問卦] 手機號碼不是自己的名字掃實聯制有用嗎？,Sun May 23 09:25:02 2021
7,7,0,zombiechen (zom),Re,Sun May 23 08:50:25 2021
14,3,11,dream21504 (alex),[問卦] 為什麼BNT衛福部不自己進就好了,Sun May 23 02:14:59 2021
9,1,8,startupownbs (Do some thing),Re,Sun May 23 02:25:03 2021
18,1,17,HD0621 (HD0621),[問卦] 疫苗國家隊 大家期不期待???,Sun May 23 07:14:07 2021
2,2,0,zero00072 (赤迷迭),[問卦] 魯宅禁了一個星期慾，能校正回歸嗎？,Sun May 23 07:04:14 2021
0,3,-3,abc1204 (         ),Re,Sun May 23 09:56:13 2021
22,3,19,kinjk01 (小白),[問卦] 台灣究竟什麼時候開始落後韓國？,Sun May 23 09:30:46 2021
7,1,6,pcshgod (pcshgod),[問卦] 請問會有多重校正回歸嗎？,Sun May 23 09:58:10 2021
8,0,8,a828203 (),[新聞] 桑默斯：加密幣有成為數位黃金的潛力,Sun May 23 06:39:19 2021
25,3,22,kenny1300175 (蘇湖),[新聞] 人夫連3天車上「握奶凍」小三嬌嗔 音檔曝光！法官臉紅、人妻臉綠了,Sun May 23 08:32:08 2021
12,16,-4,bemyangel (天使的羽翼),[問卦] 打台灣國產疫苗為何重要?,Sun May 23 03:24:30 2021
5,0,5,hrma (資深象迷),"[問卦] 所以是我們呆頑狼傲嬌, 不是中國不救???",Sun May 23 06:37:06 2021
4,0,4,todao (心裡有數),[問卦] 愛我到今生 不要問來生,Sun May 23 02:19:44 2021
92,24,68,Kazetachinu (辛普森ㄏㄏ ),[新聞] 隨機砍人！56歲男家庭失和 持刀砍超商女,Sun May 23 02:51:01 2021
26,0,26,manhaspen (男人有筆),[問卦] 哪個卡通人物的媽媽最會做菜？,Sun May 23 02:40:28 2021
4,0,4,LeonardoChen (LeonardoChen),Re,Sun May 23 02:21:49 2021
8,6,2,jefflin555 (196白白),[問卦] 現在友邦與台灣斷交各位會覺得生氣嗎？,Sun May 23 02:57:39 2021
2,5,-3,feeks (菲客絲不會有問題上來討.),Re,Sun May 23 07:05:58 2021
5,1,4,hewolf (hewolf),Re,Sun May 23 02:28:09 2021
3,1,2,cloud72426 (數字只是輔助不是真理),Re,Sun May 23 08:00:17 2021
6,1,5,Vendetta (V),[問卦] 英國靠封城+疫苗 才控制住英國變種病毒,Sun May 23 02:44:31 2021
1,0,1,LT134P (Azan),Re,Sun May 23 07:59:41 2021
41,9,32,peter950071 (小花),[問卦] 這樣的日子還要多久？,Sun May 23 02:49:58 2021
13,0,13,xiemark (aisinjuro),[問卦] 中央社新聞說400人是追加確認?,Sun May 23 06:50:16 2021
15,0,15,ILOVEluee (天天開心),[問卦] 檢驗量能無法提升 就不知道當日確診數？,Sun May 23 07:21:32 2021
1,0,1,baidu (Dr.百度™),Re,Sun May 23 01:39:28 2021
5,7,-2,arnold3 (憂鬱型男阿雲),[問卦] 中媒是不是惟恐天下不亂 一直報中國美國,Sun May 23 09:25:35 2021
23,1,22,hcltaiwan (HCL強酸無敵),[問卦] 請問明天就要上班該怎麼辦,Sun May 23 09:32:34 2021
6,0,6,EVEA (止痛錠.),[問卦] 警察沒稽查到台積電3員工不帶口罩,Sun May 23 01:56:33 2021
4,0,4,nemies (...),Re,Sun May 23 04:53:41 2021
4,7,-3,dispptt (dispptt),[問卦] 生過小孩的女生是不是各種不怕被看奶阿??,Sun May 23 02:19:13 2021
5,0,5,ericayou (vorka era),[問卦] 實驗數據校正回歸被教授譙是沒有價值嗎,Sun May 23 09:56:10 2021
9,1,8,love113w (),[問卦] 起司蛋餅加番茄醬是哪個教派的,Sun May 23 07:54:24 2021
5,1,4,littleyuan (baby),Re,Sun May 23 01:30:57 2021
4,1,3,seand8088503 (あいうえお),[問卦] 有打工仔被疫情影響沒班上的嗎？,Sun May 23 03:14:47 2021
3,0,3,ghghfftjack (慾望深厚的老衲),Re,Sun May 23 01:37:08 2021
23,5,18,a9940597 (假摔哥),[問卦] 台灣怎麼會變成這樣？,Sun May 23 08:37:25 2021
4,1,3,fixer (修理工),[問卦] 校正回歸，確診算哪一天的標準是什麼?,Sun May 23 03:16:16 2021
3,3,0,NICEGOGO (平凡平凡),[問卦] Persona5的認知作戰,Sun May 23 01:42:34 2021
0,0,0,danic (好運旺旺來),[問卦] 國產疫苗  V.S  莫德納  都幾?,Sun May 23 09:59:27 2021
16,4,12,cj3x04gp6 (90年代nba跪古濺今迷),[問卦] 張量潁有一首歌紅過嗎?,Sun May 23 09:46:40 2021
5,4,1,zxc445567 (飄飄),[問卦] 台灣是不是沒有像三星的財閥？,Sun May 23 09:16:05 2021
3,1,2,biting (菜B),[問卦] 很遠的地方有個女郎 名字叫做耶利亞,Sun May 23 02:40:28 2021
2,0,2,pili012140 (mike),[問卦] 謀財害命再來是什麼？,Sun May 23 09:24:13 2021
15,2,13,aceral1916 (我好興奮rrrrrrrrrrrrrrr),[問卦] 我的SPSS沒有校正回歸怎麼辦? 在線等,Sun May 23 04:51:13 2021
169,137,32,GGGGININDER (),[新聞] 調查局有動作了！　加強情蒐「網友討論校正回歸」,Sun May 23 08:20:38 2021
2,3,-1,toro556613 (立禾),[問卦] 再一次無薪假OK嗎？,Sun May 23 03:45:41 2021
254,31,223,macpaul (琴韻),[爆卦] 阿中部長一夜白頭其實有修圖？？,Sun May 23 02:20:50 2021
0,0,0,arsonlolita (蘿莉塔大魔王),[公告] 八卦板板規(2021.05.11),Tue May 11 15:03:06 2021
4,1,3,popia77 (pia),[問卦] 有因為怕死卻被拿來自嗨的卦嗎？,Sun May 23 04:14:31 2021
11,9,2,vonannes (),[問卦] 有沒有八卦板網軍有夠傲嬌的八卦,Sun May 23 09:11:45 2021
7,7,0,mean (低智商生活),Re,Sun May 23 02:24:14 2021
9,0,9,micoun828 (micoun),[問卦] 有校正的校正回歸嗎？,Sun May 23 01:37:43 2021
16,6,10,Lawleit (大員郭奉孝),[問卦] 政府為啥不能買大陸bnt疫苗？,Sun May 23 09:24:37 2021
1,1,0,oberon1013 (破420了.),[問卦] 校正回歸,Sun May 23 09:51:08 2021
0,0,0,Nick87061319 (Nick),Re,Sun May 23 09:56:44 2021
3,1,2,as23305747 (BBQ),[問卦] 國軍吃美豬？,Sun May 23 09:14:57 2021
3,0,3,hahagirls (布丁),Re,Sun May 23 01:30:47 2021
4,1,3,ddaaemon (天使惡魔),Re,Sun May 23 09:41:59 2021
8,2,6,Bastille (巴士底),[問卦] 有人最近生活也沒啥改變的八卦嗎？,Sun May 23 07:42:03 2021
7,2,5,pp5434 (),[問卦] 外帶大埔鐵板燒大辣加蔥蛋爽不爽,Sun May 23 02:07:53 2021
0,0,0,aoilight (Aoilight),,
8,1,7,leighmeow (warau),Re,Sun May 23 08:37:58 2021
6,0,6,mucorn (MU),[問卦] 裝睡的人叫不醒怎麼辦?,Sun May 23 06:55:49 2021
6,1,5,vy8824 (巴塞隆納- 紐塞),[問卦] 四個月海陸 vs 6個月替代役,Sun May 23 07:24:42 2021
1,0,1,rock1986 (夢が人生をつくるのです),Re,Sun May 23 09:42:44 2021
15,2,13,ilovemami (聯絡簿教主),Re,Sun May 23 04:46:05 2021
10,0,10,ubcs (覺★青年超冒險蓋),[公告] 523新增違規案例及上周校正回歸個案 水桶,Sun May 23 06:49:09 2021
4,1,3,leoyuan (糜爛生活該結束了),Re,Sun May 23 02:13:38 2021
26,4,22,soulboy330 (stay the course),[問卦] 什麼時候四級警戒？,Sun May 23 01:55:27 2021
5,0,5,Lucky0105 (洋),[問卦] 頭文字D 算是好玩的賽車遊戲嗎?,Sun May 23 08:04:48 2021
2,0,2,ptt987654321 (),Re,Sun May 23 07:18:36 2021
184,16,168,hoin (◎_◎),[問卦] 范雲和華航到底要躲到哪時候,Sun May 23 09:26:18 2021
3,3,0,Romeo5566 (羅密歐),[問卦] 你有被男友或老公 大聲過嗎?,Sun May 23 02:07:48 2021
3,0,3,neiltsang (楚留香雞排),[問卦] 犀利人妻是不是在諷刺乖乖牌?,Sun May 23 02:04:39 2021
671,270,401,blackdog173 (黑狗),[問卦] 幾年內票不會投給民進黨,Sun May 23 07:44:20 2021
1,0,1,NEX4036 (Ryotsu),[問卦] 黑暗之中閉上眼,Sun May 23 05:39:07 2021
0,0,0,Trozy (藍),[問卦] 工程師的人生是不是屌打8+9？,Sun May 23 10:00:05 2021
12,5,7,words2012 (づ′・ω・),[問卦] 哇!林瑞陽的兒子非常俊俏!,Sun May 23 01:44:29 2021
13,1,12,hung31017 (亞拉陽),[問卦] 碧潭這邊突然一聲爆炸聲,Sun May 23 01:43:51 2021
6,8,-2,gracew0709 (Selective mutism),[問卦] 阿辰師的油封鴨腿三大疑問,Sun May 23 03:13:05 2021
10,22,-12,viclin1982 (不能鬆懈啊),Re,Sun May 23 01:47:55 2021
43,8,35,bezbol (o.o),[問卦] 為何啟動三四級不連帶紓困政策？,Sun May 23 08:00:47 2021
18,5,13,gg0815 (O0O0O0O0O0O0O0),[問卦] 蘋果指紋辨識會回歸的八卦,Sun May 23 02:47:51 2021
104,61,43,longyin (龍吟很難嗎？為什麼),Re,Sun May 23 05:49:40 2021
5,0,5,plutox (網路上的芳鄰),[問卦] 會給光頭的理髮師剪頭髮嗎？,Sun May 23 07:09:49 2021
550,87,463,kuku321 (halipapon),[問卦] 就算校正回歸有理 CDC這禮拜作法合邏輯?,Sun May 23 04:39:29 2021
22,5,17,WaWa3 (寂寞的麻糬),[問卦] 我這輩子還有機會和台女做愛嗎？,Sun May 23 07:56:31 2021
9,1,8,haijin (),[新聞]    阿根廷再封城9天 總統宣布嚴格控管政策,Sun May 23 07:49:21 2021
10,1,9,taiwannext (2016綠營重新執政 ),[問卦] 八卦板上不信美國會給台灣武肺炎疫苗？,Sun May 23 07:09:13 2021
11,2,9,wahaha23 (請勿拍打餵食),[爆卦] 20-21西班牙甲級聯賽冠軍,Sun May 23 01:53:15 2021
4,8,-4,kkk264411 (EL),[問卦] 請問被辱罵可以用準備收傳票嚇人嗎？,Sun May 23 03:52:08 2021
7,0,7,iecju520 (哎依喜德魯),[問卦] 3+11的真相背後的真相,Sun May 23 05:46:20 2021
3,0,3,x30020357 (JIMBO),[問卦] 為什麼今年這波都沒有人要補助,Sun May 23 08:34:19 2021
47,5,42,Birthday5566 (生日5566),[問卦] 好騙的人有什麼特徵？,Sun May 23 08:08:14 2021
7,7,0,taker627 (你馬英九嗎?),[問卦]  人一綠就腦殘 誰贊成誰反對,Sun May 23 08:19:36 2021
0,0,0,hrma (資深象迷),[問卦] Yaneer Bar-Yam是甚麼咖?很有名嗎???,Sun May 23 06:47:43 2021
11,3,8,saniblue (sanity),[問卦] 如果能讓疫情戰犯罪有應得，你會怎麼做？,Sun May 23 03:43:42 2021
0,0,0,Townshend (Pete),[問卦] 參加早上記者會的記者在想什麼?,Sun May 23 10:07:12 2021
4,0,4,devidevi (凱特),Re,Sun May 23 08:47:48 2021
10,9,1,IamCuteGirl (CuteGirl5566),[問卦] 中國死了一隻土狗怎全國奔喪？,Sun May 23 01:53:10 2021
1,1,0,Icestorm (小朋友),[新聞] 疫情不敢去傳統市場 經部「買菜網」全台2,Sun May 23 01:48:19 2021
20,1,19,LineageM (天堂M),[問卦] 肉肉的 豐滿的 差別？,Sun May 23 01:41:05 2021
5,0,5,roygg (roygg),Re,Sun May 23 02:04:46 2021
79,10,69,KTR5566 (KTR),[問卦] 為什麼有辦法校正回歸前一天的資料？,Sun May 23 09:14:04 2021
0,1,-1,freeclouds (創造自己新的人生),Re,Sun May 23 08:57:31 2021
5,0,5,DragonQuest (尚未認證通過),Re,Sun May 23 04:02:15 2021
4,3,1,newlly (自古多情空餘恨),Re,Sun May 23 07:58:13 2021
1,0,1,wakaura (wakaura),[問卦] 過去一週是肥宅洗手頻率最高的嗎?,Sun May 23 09:41:42 2021
4,2,2,huan0 (A5688),[問卦] 取消每天開記者會或換時段是否更好？,Sun May 23 09:27:19 2021
5,0,5,keyesleo (以前曾經很帥),[問卦] 想問 目前國產疫苗，有哪些檯面上的政治人物是,Sun May 23 08:16:18 2021
2,0,2,sweetmiki (米奇Tama子),[問卦] 現在可以光明正大去旅館談事情了吧？,Sun May 23 01:40:26 2021
3,0,3,g10 (機會是留給準備好的人),Re,Sun May 23 08:59:54 2021
1,0,1,emuless (emuless),[問卦] 說謊騙人也可以校正回歸嗎,Sun May 23 08:15:09 2021
1,1,0,nick55chen (HATE_Chi),[問卦] 綫性回歸最慘的案例是香港嗎？,Sun May 23 08:14:11 2021
8,0,8,meltdown (自己只有自己而已),[問卦]跑飛鏢酒吧的機師安全下庄了吧?,Sun May 23 08:57:20 2021
2,0,2,AASoymilk (AASoymilk),[問卦] 防範認知作戰是調查局的工作嗎？,Sun May 23 09:43:09 2021
1,2,-1,ilove640 (子夜),Re,Sun May 23 02:32:45 2021
3,3,0,semna (11),Re,Sun May 23 02:43:15 2021
8,5,3,winnabe (請你不要迷戀哥),[問卦] 譚得塞 塞哥484其實還滿挺台灣的？,Sun May 23 09:38:34 2021
6,2,4,martylin (XYZ),[問卦] 自發性封城真的是台灣人的素質？,Sun May 23 08:16:59 2021
7,6,1,sf910132 (飛過天空的羽毛yy),"[問卦] 警察局隨時可進入,看到警察用餐要檢舉?",Sun May 23 09:42:33 2021
0,0,0,ppp123 (鋼鐵韓粉-P哥),[問卦] 如果實名QR  走進足跡店內會怎樣？,Sun May 23 10:05:33 2021
20,27,-7,hong1126 (ⒽⓄⓃⒼ①①②⑥是喵),[問卦]   想打上海復星BNT的請進,Sun May 23 08:05:33 2021
9,0,9,Dinenger (低能兒),[問卦] 偷偷蓋牌不會被人發現吧？,Sun May 23 02:15:07 2021
1,1,0,enderboy7652 (要憐憫戰人仔),[問卦] 484應該要還給新一代一個公道,Sun May 23 09:47:13 2021
8,1,7,abc0312 (ABC),Re,Sun May 23 07:38:16 2021
8,6,2,medlife0830 (allen game),[問卦] 如果台灣不是民主國家了？,Sun May 23 08:31:55 2021
23,9,14,anono (nono),Re,Sun May 23 08:37:56 2021
4,3,1,musicaledio (桃機金泰坪),[問卦] 現在假日去北車該穿什麼的八卦,Sun May 23 01:38:04 2021
9,2,7,jazzcai (如果有一天),[問卦] 今天會是幾加幾再加幾？,Sun May 23 09:06:42 2021
76,43,33,NARUTO (鳴人),[問卦] 為什麼國產疫苗研發速度遠遠地落後世界？,Sun May 23 07:44:51 2021
6,0,6,ZengMaktub (YOYOMAK),[問卦] 所以政府補助方案出來了嗎,Sun May 23 06:54:42 2021
4,0,4,manphis (...),[問卦] 台灣人施打疫苗的數量,Sun May 23 09:19:48 2021
3,0,3,JyumonjiKaho (十文字かほ),[新聞] 奈及利亞陸軍參謀長墜機亡 正值北部平亂,Sun May 23 07:26:36 2021
5,2,3,mikemagic88 (Mikemagic88),Re,Sun May 23 03:55:39 2021
31,34,-3,GreenBeret (綠扁帽),[問卦] 只有我覺得上海復星根本不想賣bnt給台灣?,Sun May 23 01:59:29 2021
10,0,10,POWERSERIES (Zen),[問卦] Donki Donki 老闆現在在想什麼,Sun May 23 09:52:23 2021
113,6,107,littlered112 (H.B.Rothschild),[問卦] 一天開兩次會的意義,Sun May 23 09:48:47 2021
17,6,11,bjqs0827 (sqangela),Re,Sun May 23 09:31:17 2021
8,0,8,lelena (智慧之神-透特),"[問卦] 如果產線確診,需不需要整間公司關閉八卦?",Sun May 23 09:23:42 2021
7,1,6,NotOrdinary (習慣就好),[問卦] 是不是有「造神學系」啊？,Sun May 23 09:26:11 2021
12,1,11,sodistrues (true),[問卦] 喝了泰國富江nanno的血能抗武漢肺炎嗎？,Sun May 23 08:44:19 2021
1,0,1,Bainite (黑羽毛 ┐(′д`)┌),Re,Sun May 23 05:45:20 2021
0,0,0,shampoopoo (毛寶洗髮精),[問卦] 馬自立唱好想死的八卦,Sun May 23 10:07:45 2021
6,0,6,HD0621 (HD0621),[問卦] O2氧氣板防疫期間還在狂徵的八卦?,Sun May 23 08:04:55 2021
10,7,3,happinessi (felthappinessandgotit),Re,Sun May 23 07:32:17 2021
21,3,18,duane (同天內只計一次),[問卦] 今天大的便是不是要算在前幾天的食物上,Sun May 23 01:32:02 2021
7,0,7,arace88 (Arace),Re,Sun May 23 08:32:46 2021
14,12,2,earning (earning),[新聞] 事後校正回歸 國外公衛統計常見,Sun May 23 09:23:38 2021
13,0,13,injeccc (哥哥我好癢 ^_^/),[問卦] 高雄終於下雨了，喔耶 ^_^,Sun May 23 08:11:13 2021
7,3,4,Townshend (Pete),[問卦] 到昨天才知道要校正回歸嗎？,Sun May 23 08:11:20 2021
4,4,0,bradpete (姆咪輪班星人),[問卦] 起手式「之前投給XXX」都是哪種人？,Sun May 23 09:50:09 2021
2,0,2,Lourmu (Loumu),Re,Sun May 23 01:47:00 2021
1,0,1,brokenback3 (3),Re,Sun May 23 09:10:55 2021
0,0,0,joyca (joyca),[問卦] 王育誠是不是生不逢時？,Sun May 23 10:04:04 2021
6,1,5,lelena (智慧之神-透特),[問卦] 星際大戰設定不合理的八卦?,Sun May 23 09:39:37 2021
3,1,2,khfcgmbk (三毛兒),[問卦] 疫情期間財富自由的人都在幹嘛？,Sun May 23 02:04:03 2021
10,3,7,danny0830 (丹尼),[問卦] 軍營人擠人為何都沒人確診？,Sun May 23 07:31:46 2021
52,14,38,nexo (nexo),[問卦] BNT疫苗打一劑要一萬 你打嗎,Sun May 23 03:15:10 2021
3,0,3,MafuyuShiina (MafuyuShiina),[新聞]強化「大山貓」步兵戰鬥車防禦力 匈牙利,Sun May 23 06:52:20 2021
10,4,6,seand8088503 (あいうえお),[問卦] 日本外科這麼強 為啥沒研發疫苗？,Sun May 23 02:59:15 2021
4,0,4,li7915566 (小傻瓜),[問卦] 萬華是日式地名嗎？,Sun May 23 09:53:59 2021
0,0,0,smallx4321 (叔叔),[問卦]  出門去沒人的地方會變防疫破口嗎？,Sun May 23 10:01:42 2021
51,4,47,s81669 (jack),[問卦] 如果不買BNT，是不是也在賭？,Sun May 23 02:31:21 2021
55,20,35,chun0303 (chun),[新聞] 洪秀柱願當「橋樑」引入中國疫苗　指揮,Sun May 23 08:57:32 2021
65,5,60,ubcs (覺★青年超冒險蓋),[公告] 周六新增大量校正回歸水桶案例,Sat May 22 23:22:14 2021
6,1,5,actuary35 (time actuary),[問卦] 自殺者再利用是否可行？,Sun May 23 08:15:59 2021
4,2,2,FZ5566 (激怒全世界),Re,Sun May 23 08:42:16 2021
4,0,4,pp5434 (),Re,Sun May 23 01:43:15 2021
0,0,0,zcliu026 (KKK),[問卦] 台灣10年內還有甚麼未爆彈會炸開?,Sun May 23 10:04:06 2021
94,2,92,qwerapple (nomaman),[問卦] 我不同意你的觀點，下一句怎麼接？,Sun May 23 08:49:27 2021
10,2,8,a032889650 (小胞子),[問卦] 又忘記帶鑰匙的我該做什麼,Sun May 23 07:38:25 2021
5,3,2,aynmeow (我想成為安康魚),[問卦] 欸幹這個是不是真的!??,Sun May 23 03:28:28 2021
58,4,54,JUNOCARE (陽光！！),[問卦] 台灣人是不是只有等國產疫苗的命運?,Sun May 23 01:46:53 2021
461,32,429,r2650662 (Anchor),[問卦] 有人也面臨倒閉邊緣了嗎,Sun May 23 03:00:48 2021
19,7,12,aabbcc520 (U質文),[問卦] 30歲要如何吸引女人的八卦,Sun May 23 09:25:55 2021
21,0,21,s999132 (Anna),[問卦] 會校正回歸為什麼不早說,Sun May 23 02:30:31 2021
9,0,9,joywilliamjo (joywilliamjoy),[問卦] 麻辣鍋應該要沾香油還是沙茶醬還是不沾,Sun May 23 02:38:59 2021
4,0,4,pp5434 (),[問卦] 有沒有人最近吃外帶還滿爽的,Sun May 23 01:33:41 2021
8,0,8,xzcb2008 (麻瓮！日本變態貓貓),[問卦] =.= 疫情宅在家每天螢幕9小時！？,Sun May 23 09:05:56 2021
3,0,3,yl3218 (小件),Re,Sun May 23 01:51:25 2021
8,1,7,farmer (^_^),"[問卦] 當初錯押川普,怎樣才能讓拜登息怒？",Sun May 23 08:58:15 2021
12,3,9,ssdavid (^^),[問卦] 為什麼捐了口罩卻沒有疫苗?,Sun May 23 03:52:17 2021
9,1,8,WuDunE (GLAUCUS),[問卦] 300萬能幹嘛,Sun May 23 09:08:23 2021
4,2,2,polostar (螺絲塔),[問卦] 疫苗是不是防疫戰爭的救援投手,Sun May 23 04:32:52 2021
12,2,10,neil136 (↑↑↓↓←→←→BA),Re,Sun May 23 08:33:34 2021
1,0,1,MarkFung (馬克方),Re,Sun May 23 09:01:39 2021
9,1,8,ben108472 (ben108472),[問卦] 美國疫苗都不優先給台灣，戰爭會介入嗎？,Sun May 23 08:56:43 2021
8,0,8,a002255889 (人肉葛拉漢),Re,Sun May 23 06:23:16 2021
3,6,-3,Behind4 (背後4),[問卦] 228白色恐怖是為了救台灣吧？,Sun May 23 08:32:42 2021
9,5,4,efthu456 (小哲),[問卦] 工作後越來越厭世正常嗎,Sun May 23 02:45:20 2021
7,1,6,kingtama (立志成為唬爛王),[問卦] 綠共會不會變抓耙仔？,Sun May 23 09:19:23 2021
3,1,2,songgood (ilovegoodgame),[問卦] 千聖是有什麼毛病,Sun May 23 06:32:22 2021
6,0,6,skylion (溫暖的傳說),Re,Sun May 23 08:11:22 2021
1,2,-1,Kaids (凱凱),Re,Sun May 23 01:50:43 2021
9,0,9,gfhnrtjpoiuy (亂碼1/2),[問卦] 男女之間沒有純友誼,Sun May 23 07:14:08 2021
5,2,3,Kimmy (Kimi),[問卦] 武漢人還會被岐視嗎？,Sun May 23 08:39:58 2021
4,2,2,mikemagic88 (Mikemagic88),[問卦] 電子鎖實用還是不實用?,Sun May 23 07:50:25 2021
0,0,0,TZULIU (消費券收購商),Re,Sun May 23 09:59:46 2021
1,4,-3,scottaa (貓貓),什麼情況下平板會是首選,Sun May 23 06:59:17 2021
35,6,29,medlife0830 (allen game),[問卦] 美豬都吞了 爸爸怎麼不給疫苗？,Sun May 23 08:42:46 2021
6,0,6,Enota (if.then.else.),[問卦] 二延平即時影像,Sun May 23 08:54:21 2021
0,0,0,Ophiuchus (人帥真好！警消傻眼),[問卦] 台灣人是大青蛙還是大菊花? (影片),Sun May 23 10:03:31 2021
15,10,5,bighouse (加貝),[問卦] 是不是該把傾中當籌碼了？,Sun May 23 09:57:22 2021
4,1,3,a10192437 (Sharon),[問卦] 生理時鐘也被校正了嗎,Sun May 23 06:15:55 2021
6,0,6,jones210272 (hy鐵粉),[問卦] 慟！鐵板燒外帶中辣配啤酒也太爽了吧！,Sun May 23 02:03:21 2021
4,1,3,Superxixai (洪粉吱已),[問卦] 感染源都是武漢，所以沒有不明？,Sun May 23 07:23:25 2021
7,2,5,squard (sun),[問卦] 疫情終究會過去der,Sun May 23 09:07:38 2021
8,12,-4,isud40401 (何金銀),[問卦] 新冠肺炎是否被過度渲染報導了？,Sun May 23 07:28:05 2021
2,4,-2,y3226999 (咪苦說她喜歡我 >///<),[問卦] 初音會敬老尊賢嗎==？,Sun May 23 03:01:29 2021
9,3,6,juangpeiyi (給還沒有遇見的你),[問卦] 輝瑞BNT疫苗營銷劃分,Sun May 23 03:05:56 2021
20,3,17,kasumi5566 (霞),[問卦] 日清泡麵、阿Q桶麵、滿漢大餐，都幾,Sun May 23 01:32:22 2021
4,0,4,yycbr (專注力+10),Re,Sun May 23 08:34:36 2021
3,0,3,wewf22 (二乃是天),[問卦] 有沒有26的智媒體到底可不可信的八卦,Sun May 23 08:33:35 2021
10,1,9,pammpamm (pammpamm),[問卦] 水泡該怎麼處理？(有圖，不喜勿入),Sun May 23 01:30:37 2021
5,0,5,eeuueee (eee),[問卦]柏毅有強迫你放在門口嗎？,Sun May 23 07:42:49 2021
4,1,3,jayemshow (S.Kazumi),Re,Sun May 23 01:42:01 2021
12,3,9,polyhome (小天),[問卦] 今天應該沒人猜神秘數字了吧,Sun May 23 08:31:03 2021
3,9,-6,ioupoiu (他媽的噁心甲),Re,Sun May 23 09:28:49 2021
37,8,29,Ryo5566 (),[問卦] 蟑螂4不4又變多了?,Sun May 23 08:51:48 2021
89,24,65,Refauth (山丘上的長號手),[新聞] 美專家建議台灣 越早封城代價越小,Sun May 23 08:25:55 2021
37,9,28,tist (啊我就怕被罵),[新聞] BioNTech 新加坡生產新冠疫苗,Sun May 23 01:42:57 2021
204,635,-431,ubcs (覺★青年超冒險蓋),[公告] 置底大怒灌Hate閒聊區,Fri May 14 13:58:47 2021
1,1,0,romanticsea (手指與琴弦的對話),[問卦] 預防停電的超前部屬?,Sun May 23 09:17:57 2021
6,3,3,linhuangzuo (K.M.H.M tight),[問卦] 請問我朋友這樣是生病了嗎,Sun May 23 04:42:01 2021
110,7,103,ga86041 (ga86041),[爆卦] 地震,Sun May 23 03:58:05 2021
2,4,-2,samok (記者只會抄公社低卡記錄7),[爆卦] 地震報告,Sun May 23 01:51:40 2021
13,4,9,MoToBlue (MoToBlue),[問卦] 這樣是越來越少還是越來越多呢,Sun May 23 07:30:33 2021
21,5,16,jinnsei (人生),[問卦] 萬華明明就是紅燈區，為什麼沒人想正名,Sun May 23 09:43:38 2021
7,1,6,TPEE (TPE),[問卦] 坐船去公海打疫苗可行嗎？,Sun May 23 03:11:18 2021
113,41,72,quantus (quantus),[問卦] 請衛服部公開上海復星3000萬劑BNT 報價,Sun May 23 07:20:53 2021
124,22,102,leocean9816 (阿光),[新聞] 台灣連一週單日確診破百 美專家：快速,Sun May 23 04:07:38 2021
906,32,874,MiLuDaiBoom (ⓂⓛⓁⓤⒹⓐⓛⒷⓞⓞⓂ),[問卦] 雲朵推怎麼用的？,Sun May 23 03:18:03 2021
30,4,26,oaoa0123 (OldFlame),[問卦] 譚德賽的疫苗都肯打了有BNT的不要？,Sun May 23 09:18:05 2021
7,0,7,Surlyn (肥仔),[問卦] Costco的配鏡技術如何,Sun May 23 01:34:49 2021
5,44,-39,canvas0403 (wade fans),[問卦] 這個時間沒有人會噓吧？,Sun May 23 07:08:20 2021
0,0,0,wegoliving (HYSTERIC),[問卦] 成龍怎麼看台灣防疫？,Sun May 23 10:05:19 2021
13,5,8,Behind4 (背後4),[問卦] 台灣還能盡情的罵政府嗎?,Sun May 23 09:43:22 2021
31,0,31,ken0714 (ken),[問卦] 陽性率趨穩 但記者是不是圖文不符,Sun May 23 09:49:55 2021
57,5,52,whiteadam (blue eyes blue),[問卦] 國產疫苗 大家覺得怎樣?,Sun May 23 02:40:54 2021
9,0,9,simpleduck (simplelife),Re,Sun May 23 08:57:32 2021
61,4,57,bota (llll),[問卦] 感覺霍金的說法不是很正確???,Sun May 23 07:41:13 2021
5,1,4,xxx80076 (xxx80076),"[問卦] 智慧手機沒問世,人民能否自律宅在家？",Sun May 23 09:14:17 2021
10,3,7,richshen (哇哈哈),[問卦] 命重要還是抗中保台重要?,Sun May 23 01:30:12 2021
8,1,7,hfs (快樂!移民日本!夢想成真!),[問卦] 覺得活著很累的時候.該怎麼辦?,Sun May 23 09:55:35 2021
24,4,20,olite (olite),[問卦] 輝瑞，莫德納，AZ疫苗  差在哪邊？,Sun May 23 09:48:31 2021
3,0,3,skylion (溫暖的傳說),Re,Sun May 23 06:58:25 2021
1,3,-2,cj3x04gp6 (90年代nba跪古濺今迷),[問卦] 任然開得起演唱會嗎?,Sun May 23 09:56:51 2021
0,0,0,luke0205 (luke0205),"[問卦] 雙北公布案例跟中央不同,這樣不算假消息?",Sun May 23 09:53:04 2021
5,1,4,A6 (短ID真好),Re,Sun May 23 01:47:52 2021
11,4,7,z5419 (邱哥),[問卦] 台北市現在接近空城壯態,Sun May 23 03:26:43 2021
12,1,11,Dinenger (低能兒),[問卦] 校正回歸有其正當性吧？,Sun May 23 02:06:43 2021
1,3,-2,Golf19 (19Golf),[問卦] 缺晶片會不會是台積電沒去申請？,Sun May 23 02:36:52 2021
0,0,0,jasonlin2100 (jasonlin),[問卦] 地方政府能自己買BNT疫苗嗎？,Sun May 23 10:07:59 2021
1,2,-1,k90209 (k90209),[問卦] 為什麼我的mba在桌面滑動會lag?,Sun May 23 09:44:39 2021
25,17,8,kuoalan0819 (阿輝),[新聞]疫情爆發後聲量排行，柯文哲加侯友宜還比,Sun May 23 09:03:41 2021
11,0,11,hiball (魔鬼肥肉人),Re,Sun May 23 02:12:53 2021
91,4,87,a09651238 (可口美味好滋味),[新聞] 印度洋發現大量野生腔棘魚!!!!,Sun May 23 08:37:17 2021
3,0,3,Akrios (Akrios),[問卦] 包龍星直播,Sun May 23 02:25:21 2021
76,5,71,ohfly (行動才是真實的),[新聞] 英最新研究：輝瑞和AZ疫苗對印度變種病毒,Sun May 23 09:11:40 2021
5,2,3,Hsins (迅雷不及掩耳盜鈴),Re,Sun May 23 01:59:06 2021
5,4,1,kons (kons),[問卦] 本魯所在的區域是不是高風險了啊？,Sun May 23 04:29:52 2021
0,0,0,w1230319 (龜山金城武),[問卦] 100年後台灣歷史課本怎麼形容2021年？,Sun May 23 10:00:26 2021
34,3,31,tearcolor (....),[問卦] 疫情七個未解之謎,Sun May 23 02:43:42 2021
3,5,-2,z5419 (邱哥),[問卦] 預知夢,Sun May 23 02:51:55 2021
4,0,4,VVizZ (我很窮),[問卦] 美廉社VV系列的茶品是不是屌打？,Sun May 23 01:43:11 2021
21,1,20,ThePeaceMan (TPM),[問卦] 你們生活中碰過哪些天才?,Sun May 23 02:25:23 2021
57,3,54,joywilliamjo (joywilliamjoy),[問卦] 日本咖哩 vs 印度咖哩 都幾,Sun May 23 02:03:12 2021
20,1,19,lopiuytio (),[問卦] 台灣人民看起來很傻嗎？,Sun May 23 09:38:39 2021
9,3,6,cj3x04gp6 (90年代nba跪古濺今迷),[問卦] 小蘋果和最炫民族風哪首更紅?,Sun May 23 09:14:26 2021
20,9,11,GrimmNotes (格林童話),[新聞] 八通關大火禍首 NCC專委要賠2000萬,Sun May 23 09:44:05 2021
0,0,0,kopuck (派翠克星星),[問卦] 我想認識網美啦！！！！！！！,Sun May 23 10:04:05 2021
6,3,3,you1111 (內科南柱赫),[問卦] 路上怎麼都沒人,Sun May 23 02:00:08 2021
1,0,1,thewtf (濱邊美波我老婆),[問卦] 白石麻衣是靠乃團才紅的吧,Sun May 23 09:27:12 2021
22,3,19,iocal (IOCAL),[問卦] 心理諮商師和心理醫師推哪個,Sun May 23 03:26:09 2021
18,1,17,top1683 (我魯 故我在),[問卦] 現在口號要喊什麼,Sun May 23 08:36:43 2021
5,0,5,words2012 (づ′・ω・),Re,Sun May 23 02:19:25 2021
6,2,4,kinjk01 (小白),[問卦] 為什麼日本跟韓國不研發疫苗？,Sun May 23 02:19:42 2021
8,2,6,baelrog (貝爾羅格),[問卦] 為什麼不是打過疫苗的3+11,Sun May 23 05:58:07 2021
2,1,1,RLAPH (川尻浩作),Re,Sun May 23 07:28:34 2021
4,4,0,s66449 (老實樣),[問卦] 肥宅約曖昧女森來家裡吃午餐有加分嗎？,Sun May 23 09:45:36 2021
4,1,3,breezy1812 (茉莉花),Re,Sun May 23 01:30:37 2021
27,0,27,Mikoto41 (Zare),[問卦] 雙重快篩？,Sun May 23 07:01:34 2021
4,1,3,utdsml (阿邊肥),[問卦] 貼標籤 很爽吧,Sun May 23 03:10:59 2021
8,2,6,paneth (paneth),[問卦] 除了不戴口罩，還有哪些防疫破口？,Sun May 23 04:04:19 2021
17,2,15,ntunick (台中....XD),Re,Sun May 23 08:15:01 2021
1,4,-3,ben108472 (ben108472),[問卦] 可以用復星提賣BNT疫苗來跟美國要疫苗？,Sun May 23 06:20:36 2021
5,0,5,fickleness (小舞揭),[問卦] 偉哉CDC接下來該怎麼行銷國產疫苗？,Sun May 23 09:47:14 2021
6,2,4,DsLove710 (DoraApen),[問卦] 闖紅燈的四輪把行人當保齡球打? (中國),Sun May 23 09:49:11 2021
46,17,29,vcvca5566 (vcvca),[新聞] 印度婦新冠輕症住院　竟遭3醫護性侵變重,Sun May 23 01:48:25 2021
6,3,3,chinagay (中國同志),[問卦] 台灣同胞現在po 文是不是要多想一下,Sun May 23 09:04:56 2021
92,8,84,dzwei (Args&&... args),[問卦] 你FB覺青朋友有提過3+11這個大洞嗎?,Sun May 23 03:08:21 2021
2,0,2,douglasjs (帥到吐),[問卦] 校正回歸的真意？,Sun May 23 06:52:42 2021
7,0,7,NoPTT (YBY讚啦！),Re,Sun May 23 09:42:20 2021
6,0,6,longyin (龍吟很難嗎？為什麼),Re,Sun May 23 07:32:18 2021
13,9,4,kons (kons),[問卦] 如果台灣硬封城會有一堆人餓死吧？,Sun May 23 01:31:50 2021
15,14,1,wayne1027 (幹話百夫長),[問卦] 這總統誰選的?,Sun May 23 08:33:04 2021
6,1,5,Beanoodle (津崎似超人平匡先生),[問卦] 這波要發多少振興券才救得回來？？,Sun May 23 03:26:44 2021
7,0,7,kuma525566 (毛怪),[問卦] 我的google時間軸壞了嗎?,Sun May 23 08:19:11 2021
27,1,26,a78a78 (),Re,Sun May 23 03:06:38 2021
4,1,3,JimJackson (老JJ),[問卦] 打疫苗 病毒流感化 平常心面對 是唯一解,Sun May 23 09:03:38 2021
2,1,1,NCTUEE800808 (White Dragon Society),[問卦] 女森是不是對可愛的很難以抗拒？,Sun May 23 02:39:02 2021
2,1,1,BleedWang (),Re,Sun May 23 09:50:35 2021
4,0,4,rd5186 (GIOS),[問卦] 是不是之後只看校正回歸後的那波報告就好,Sun May 23 01:45:15 2021
32,1,31,Carmelo3 (      六甲おろし),[問卦] 5月31日有可能開學嗎？,Sun May 23 07:32:10 2021
13,4,9,flower42 (栗悟飯與龜波功),[問卦] 有沒有711起司三重奏三明治的八卦？,Sun May 23 03:12:00 2021
1,0,1,unclefucka (Comic Lo ),Re,Sun May 23 08:57:32 2021
8,1,7,lpbrother (LP哥(LP = Love & Peace)),[問卦] 台灣要送什麼才能刺激疫苗接種？,Sun May 23 09:04:37 2021
3,0,3,sakanatsuki (這不是肉搜什麼才是肉搜),[問卦] 數位轉型,Sun May 23 02:08:34 2021
5,0,5,sungastill (桑嘎斯),Re,Sun May 23 02:23:10 2021
2,13,-11,ilovettb (笑著笑著就哭了),Re,Sun May 23 03:23:14 2021
8,1,7,teeheehee (軟尾拋拋翔(′・ω・`)),[問卦] 有甚麼樣的人民就選出甚麼樣的政府,Sun May 23 09:52:31 2021
4,1,3,harryjimmyw (harry),[問卦] 現在反核的都是中共同路人嗎？,Sun May 23 09:17:40 2021
7,0,7,ilw4e (可以吃嗎？),Re,Sun May 23 05:51:25 2021
3,0,3,zapzone (問卦大師),[問卦] 蜘蛛是肥宅怎辦,Sun May 23 09:23:53 2021
20,0,20,fawangching (食品物流師Tom),[問卦] 疫情結束後 八大行業會被報復性消費嗎？,Sun May 23 08:35:41 2021
80,22,58,aiii (aiii),[新聞] 校正回歸熱議 調查局情蒐社群言論,Sun May 23 08:30:18 2021
4,0,4,bota (llll),Re,Sun May 23 09:42:24 2021
